11111
10001
11101
100N1
11111
