111111
111001
1S0001
1N0001
100001
111111