NO ./textures/bricks.xpm
SO ./textures/bricks.xpm
WE ./textures/bricks.xpm
EA ./textures/dragon.xpm

F 31,100,32
C 140,189,214

111111111111111111111111
100000000000000000000001
100000000000000000000001
100000000000000000000001
100000111110000ADGCA0001
100000100010000G000G0001
100000100010000B000B0001
100000100010000100010001
1000001DGC100001DGC10001
100000000000000000000001
100000000000000000000001
100000000000000000000001
100000000000000000000001
100000000000000000000001
100000000000000000000001
100000000000000000000001A11
111111111000000000000000G01
110100001000000000000001B11
110000101000000000000001
110100001000000000000001
110A1A11A000000000000001
110G0G00G000000000000001
111B1B11B00W000000000001
111111111111111111111111
