NO ./textures/mossy.xpm
SO ./textures/redbrick.xpm
WE ./textures/redbrick.xpm
EA ./textures/mossy.xpm

F 31,100,32
C 140,189,214

        1111111111111111111111111
        1000000000110000000000001
        1011000001110000000000001
        1001000000000000000000001
111111111011000001110000000000001
1E0000000011000001110111111111111
11110111111111011100000010001
11110111111111011101010010001
1100000011010101110000001000111111111111
1000000000000000000000001000000000000001
1000000000000000110101001000111111110001
1100000111010101111101111000111    111101
11110111 1110101 101000000001          1
11111111 1111111 11111111111
